...XXX..
........
.X......
........
.XX.....
........
.......X
.......X